sample_id	chr	start	end	value	cnv_algorithm	size
AD2	1	838555	1227897	1.0	penn_cnv	389342
RD122 80:20_B7	1	98157332	98502934	3.0	penn_cnv	345602
RD122 80:20_C2	1	17305903	17540345	1.0	penn_cnv	234442
RD122 80:20_B7	2	79001780	79198168	3.0	penn_cnv	196388
AD3_AZ	3	64755337	65054400	3.0	penn_cnv	299063
AD3_P4	3	13053937	13144375	1.0	penn_cnv	90438
AD3_P4	3	64755337	65054400	3.0	penn_cnv	299063
Kolf2-c1	3	72291638	72403467	1.0	penn_cnv	111829
LN511-B5	3	72291638	72403467	1.0	penn_cnv	111829
LN511-B5	3	61238218	61567988	3.0	penn_cnv	329770
LN511-C11	3	72291638	72403467	1.0	penn_cnv	111829
LN511-C11	3	61238218	61567988	3.0	penn_cnv	329770
LN511-D4	3	72291638	72403467	1.0	penn_cnv	111829
LN511-D4	3	61238218	61567988	3.0	penn_cnv	329770
LN511-E5	3	72291638	72403467	1.0	penn_cnv	111829
LN521-B2	3	72291638	72403467	1.0	penn_cnv	111829
LN521-B2	3	61238218	61567988	3.0	penn_cnv	329770
LN521-E2	3	72291638	72403467	1.0	penn_cnv	111829
LN521-E2	3	61238218	61567988	3.0	penn_cnv	329770
LN521-F11	3	72291638	72403467	1.0	penn_cnv	111829
LN521-G11	3	72291638	72403467	1.0	penn_cnv	111829
MG-C11	3	72310765	72403467	1.0	penn_cnv	92702
MG-D7	3	72291638	72403467	1.0	penn_cnv	111829
MG-D7	3	61238218	61639764	3.0	penn_cnv	401546
MG-E3	3	72291638	72403467	1.0	penn_cnv	111829
MG-G5	3	72291638	72403467	1.0	penn_cnv	111829
MG-G5	3	61238218	61567988	3.0	penn_cnv	329770
RD122 80:20_B7	3	79077887	79493603	3.0	penn_cnv	415716
MG-G5	6	15499419	15739843	1.0	penn_cnv	240424
RD122 80:20_B8	6	5571672	5632356	1.0	penn_cnv	60684
RD122 80:20_B8	6	33135962	33283766	1.0	penn_cnv	147804
RD122 80:20_C2	6	33135962	33283766	1.0	penn_cnv	147804
RD12280:20_C6	6	5571672	5632356	1.0	penn_cnv	60684
AD2	8	21884544	22025644	1.0	penn_cnv	141100
AD2	8	145567056	145738669	1.0	penn_cnv	171613
RD122 80:20_B1	8	144963266	145072539	1.0	penn_cnv	109273
RD122 80:20_B4	8	144963266	145072539	1.0	penn_cnv	109273
RD122 80:20_B8	8	144620183	145155408	1.0	penn_cnv	535225
RD122 80:20_C2	8	144620183	145072539	1.0	penn_cnv	452356
RD122 80:20_C4	8	144963266	145072539	1.0	penn_cnv	109273
RD12280:20_C6	8	144620183	145072539	1.0	penn_cnv	452356
RD122 80:20_B7	10	61722273	61831271	3.0	penn_cnv	108998
AD2	11	1298430	1491096	1.0	penn_cnv	192666
RD122 80:20_B1	11	828784	884543	1.0	penn_cnv	55759
RD122 80:20_B8	11	825110	884543	1.0	penn_cnv	59433
RD122 80:20_C2	11	825110	884543	1.0	penn_cnv	59433
AD2	14	105555396	105961529	1.0	penn_cnv	406133
AD2	16	335373	845819	1.0	penn_cnv	510446
Kolf2-c1	18	62133107	62229526	3.0	penn_cnv	96419
LN511-C11	18	62133107	62229526	3.0	penn_cnv	96419
LN511-E5	18	40404217	40646176	3.0	penn_cnv	241959
LN521-B2	18	62133107	62229526	3.0	penn_cnv	96419
LN521-E2	18	40404217	40646176	3.0	penn_cnv	241959
LN521-G11	18	62133107	62229526	3.0	penn_cnv	96419
MG-C11	18	40404217	40646176	3.0	penn_cnv	241959
MG-C11	18	62133107	62229526	3.0	penn_cnv	96419
MG-E3	18	62133107	62229526	3.0	penn_cnv	96419
MG-G5	18	62133107	62229526	3.0	penn_cnv	96419
RD122 80:20_B7	18	26618345	26881864	3.0	penn_cnv	263519
AD2	19	850023	1046520	1.0	penn_cnv	196497
AD2	19	3579481	3698333	1.0	penn_cnv	118852
AD3_AZ	20	30643595	31494382	3.0	penn_cnv	850787
AD3_P4	20	30643595	31511702	3.0	penn_cnv	868107
RD122 80:20_B1	20	30511108	30745269	3.0	penn_cnv	234161
RD122 80:20_B4	20	30511108	30745269	3.0	penn_cnv	234161
RD122 80:20_B6	20	30511108	30745269	3.0	penn_cnv	234161
RD122 80:20_B7	20	30511108	30745269	3.0	penn_cnv	234161
RD122 80:20_B8	20	30511108	30745269	3.0	penn_cnv	234161
RD122 80:20_C2	20	30511108	30745269	3.0	penn_cnv	234161
RD122 80:20_C4	20	30511108	30745269	3.0	penn_cnv	234161
RD12280:20_C6	20	30511108	30745269	3.0	penn_cnv	234161
AD2	22	50601063	50754363	1.0	penn_cnv	153300
AD3_AZ	22	33950537	34277434	1.0	penn_cnv	326897
AD3_P4	22	33950537	34277434	1.0	penn_cnv	326897
AD3_AZ	1	154767834	156206695	2.0	cnv_partition	1438861
AD3_AZ	1	177938243	178954089	2.0	cnv_partition	1015846
AD3_P4	1	154767834	156206695	2.0	cnv_partition	1438861
AD3_P4	1	177938243	178954089	2.0	cnv_partition	1015846
Kolf2-c1	1	100314969	100709949	3.0	cnv_partition	394980
LN511-B5	1	62908386	63201577	3.0	cnv_partition	293191
LN511-B5	1	100314969	100709949	3.0	cnv_partition	394980
LN511-C11	1	100314969	100709949	3.0	cnv_partition	394980
LN511-D4	1	97746924	98528798	3.0	cnv_partition	781874
LN511-D4	1	100314969	100709949	3.0	cnv_partition	394980
LN511-E5	1	62908386	63266810	3.0	cnv_partition	358424
LN511-E5	1	100314969	100706416	3.0	cnv_partition	391447
LN521-B2	1	100314969	100709949	3.0	cnv_partition	394980
LN521-F11	1	100314969	100709949	3.0	cnv_partition	394980
LN521-G11	1	57090886	57241234	3.0	cnv_partition	150348
MG-C11	1	62908386	63201577	3.0	cnv_partition	293191
MG-C11	1	100314969	100709949	3.0	cnv_partition	394980
MG-C11	1	235332555	235457560	3.0	cnv_partition	125005
MG-D7	1	100314969	100709949	3.0	cnv_partition	394980
MG-E3	1	62908386	63282546	3.0	cnv_partition	374160
MG-G5	1	100314969	100709949	3.0	cnv_partition	394980
RD122 80:20_B4	1	6504654	6560493	1.0	cnv_partition	55839
RD122 80:20_B7	1	156084712	156169610	1.0	cnv_partition	84898
RD122 80:20_B7	1	194270976	197061171	3.0	cnv_partition	2790195
RD122 80:20_B8	1	156035717	156130722	1.0	cnv_partition	95005
AD2	10	89625234	89692793	3.0	cnv_partition	67559
AD2	10	36905424	39150257	2.0	cnv_partition	2244833
AD3_AZ	10	89625234	89692793	3.0	cnv_partition	67559
AD3_P4	10	89625234	89692793	3.0	cnv_partition	67559
Kolf2-c1	10	89630424	89692800	3.0	cnv_partition	62376
LN511-B5	10	89625234	89692794	3.0	cnv_partition	67560
LN511-C11	10	89625234	89692793	3.0	cnv_partition	67559
LN511-D4	10	89625234	89692794	3.0	cnv_partition	67560
LN511-E5	10	89625234	89692794	3.0	cnv_partition	67560
LN521-B2	10	89625234	89692794	3.0	cnv_partition	67560
LN521-E2	10	89625234	89692794	3.0	cnv_partition	67560
LN521-F11	10	89625234	89692800	3.0	cnv_partition	67566
LN521-G11	10	89625234	89692800	3.0	cnv_partition	67566
MG-C11	10	89625234	89692794	3.0	cnv_partition	67560
MG-D7	10	89625234	89692793	3.0	cnv_partition	67559
MG-E3	10	89630424	89692794	3.0	cnv_partition	62370
MG-G5	10	89625234	89692794	3.0	cnv_partition	67560
RD122 80:20_B1	10	89625234	89692800	3.0	cnv_partition	67566
RD122 80:20_B4	10	89625234	89692793	3.0	cnv_partition	67559
RD122 80:20_B6	10	89625234	89692794	3.0	cnv_partition	67560
RD122 80:20_B7	10	89625234	89692800	3.0	cnv_partition	67566
RD122 80:20_B8	10	89625234	89692794	3.0	cnv_partition	67560
RD122 80:20_C2	10	89625234	89692793	3.0	cnv_partition	67559
RD122 80:20_C4	10	89625234	89692793	3.0	cnv_partition	67559
RD12280:20_C6	10	89625234	89692794	3.0	cnv_partition	67560
AD2	11	64494827	64590854	1.0	cnv_partition	96027
AD2	11	107904913	108218004	3.0	cnv_partition	313091
AD3_AZ	11	27510830	28574576	2.0	cnv_partition	1063746
AD3_P4	11	27510830	28574576	2.0	cnv_partition	1063746
Kolf2-c1	11	107917087	108218004	3.0	cnv_partition	300917
LN511-B5	11	107904913	108218004	3.0	cnv_partition	313091
LN511-C11	11	107904913	108218004	3.0	cnv_partition	313091
LN511-D4	11	107904913	108218004	3.0	cnv_partition	313091
LN511-E5	11	107904913	108218004	3.0	cnv_partition	313091
LN521-B2	11	107917087	108218004	3.0	cnv_partition	300917
LN521-E2	11	108009736	108218004	3.0	cnv_partition	208268
LN521-F11	11	107904913	108216596	3.0	cnv_partition	311683
LN521-G11	11	107904913	108216545	3.0	cnv_partition	311632
MG-C11	11	107917087	108218004	3.0	cnv_partition	300917
MG-D7	11	107903818	108218004	3.0	cnv_partition	314186
MG-E3	11	108009736	108218004	3.0	cnv_partition	208268
MG-G5	11	107917087	108218004	3.0	cnv_partition	300917
RD122 80:20_B1	11	47353422	47470476	1.0	cnv_partition	117054
RD122 80:20_B1	11	108012415	108218004	3.0	cnv_partition	205589
RD122 80:20_B1	11	84371220	85837369	2.0	cnv_partition	1466149
RD122 80:20_B4	11	47353422	47470476	1.0	cnv_partition	117054
RD122 80:20_B4	11	107904913	108218004	3.0	cnv_partition	313091
RD122 80:20_B4	11	84371220	85837369	2.0	cnv_partition	1466149
RD122 80:20_B6	11	108012037	108202172	3.0	cnv_partition	190135
RD122 80:20_B6	11	84371220	85837369	2.0	cnv_partition	1466149
RD122 80:20_B7	11	108012415	108216616	3.0	cnv_partition	204201
RD122 80:20_B7	11	84371220	85837369	2.0	cnv_partition	1466149
RD122 80:20_B8	11	76751147	76925653	1.0	cnv_partition	174506
RD122 80:20_B8	11	107904913	108218004	3.0	cnv_partition	313091
RD122 80:20_B8	11	84371220	85837369	2.0	cnv_partition	1466149
RD122 80:20_C2	11	47350287	47470476	1.0	cnv_partition	120189
RD122 80:20_C2	11	108012415	108218004	3.0	cnv_partition	205589
RD122 80:20_C2	11	84371220	85837369	2.0	cnv_partition	1466149
RD122 80:20_C4	11	47353422	47470476	1.0	cnv_partition	117054
RD122 80:20_C4	11	108012415	108216596	3.0	cnv_partition	204181
RD122 80:20_C4	11	84371220	85837369	2.0	cnv_partition	1466149
RD12280:20_C6	11	64520597	64577603	1.0	cnv_partition	57006
RD12280:20_C6	11	107904913	108216616	3.0	cnv_partition	311703
RD12280:20_C6	11	84371220	85837369	2.0	cnv_partition	1466149
LN511-E5	12	79072373	81091064	3.0	cnv_partition	2018691
MG-E3	12	77946801	81091064	3.0	cnv_partition	3144263
MG-E3	12	84852873	88555491	3.0	cnv_partition	3702618
RD122 80:20_B4	12	85232076	87671750	3.0	cnv_partition	2439674
RD122 80:20_B6	12	85928034	87185603	3.0	cnv_partition	1257569
RD122 80:20_C2	12	85243681	87281456	3.0	cnv_partition	2037775
AD2	13	48908860	49027250	3.0	cnv_partition	118390
AD3_P4	13	48916747	49027249	3.0	cnv_partition	110502
Kolf2-c1	13	48881489	49039169	3.0	cnv_partition	157680
LN511-B5	13	48908860	49027250	3.0	cnv_partition	118390
LN511-C11	13	48908860	49039248	3.0	cnv_partition	130388
LN511-D4	13	32912177	32979138	3.0	cnv_partition	66961
LN511-D4	13	48908860	49039248	3.0	cnv_partition	130388
LN511-E5	13	32912177	32968918	3.0	cnv_partition	56741
LN511-E5	13	48908860	49039252	3.0	cnv_partition	130392
LN521-B2	13	48881489	49039252	3.0	cnv_partition	157763
LN521-E2	13	32912150	32971071	3.0	cnv_partition	58921
LN521-E2	13	48881495	49039166	3.0	cnv_partition	157671
LN521-F11	13	32912150	32976358	3.0	cnv_partition	64208
LN521-F11	13	48908860	49027250	3.0	cnv_partition	118390
LN521-G11	13	48908860	49029385	3.0	cnv_partition	120525
MG-C11	13	48881489	49039248	3.0	cnv_partition	157759
MG-D7	13	32912150	32972367	3.0	cnv_partition	60217
MG-D7	13	48908860	49039169	3.0	cnv_partition	130309
MG-E3	13	32912166	32971071	3.0	cnv_partition	58905
MG-E3	13	48900988	49039248	3.0	cnv_partition	138260
MG-E3	13	96425265	96707990	3.0	cnv_partition	282725
MG-G5	13	32912150	32971114	3.0	cnv_partition	58964
MG-G5	13	48881495	49027250	3.0	cnv_partition	145755
RD122 80:20_B1	13	32912166	32983250	3.0	cnv_partition	71084
RD122 80:20_B1	13	48916747	49027249	3.0	cnv_partition	110502
RD122 80:20_B4	13	32890622	32979138	3.0	cnv_partition	88516
RD122 80:20_B4	13	48900988	49027249	3.0	cnv_partition	126261
RD122 80:20_B6	13	48916747	49027249	3.0	cnv_partition	110502
RD122 80:20_B7	13	32912177	33339178	3.0	cnv_partition	427001
RD122 80:20_B7	13	48916747	49027249	3.0	cnv_partition	110502
RD122 80:20_B8	13	32890627	33370859	3.0	cnv_partition	480232
RD122 80:20_B8	13	48881489	49029385	3.0	cnv_partition	147896
RD122 80:20_C2	13	32903564	33370859	3.0	cnv_partition	467295
RD122 80:20_C2	13	48908860	49027250	3.0	cnv_partition	118390
RD122 80:20_C4	13	48881489	49027250	3.0	cnv_partition	145761
RD12280:20_C6	13	32912166	33351016	3.0	cnv_partition	438850
RD12280:20_C6	13	48916747	49029385	3.0	cnv_partition	112638
MG-E3	14	67300549	67563593	3.0	cnv_partition	263044
RD122 80:20_B7	14	67300549	67563593	3.0	cnv_partition	263044
AD2	15	22321690	22463534	1.0	cnv_partition	141844
AD2	15	91274575	91346951	3.0	cnv_partition	72376
AD2	15	41210356	42264135	2.0	cnv_partition	1053779
Kolf2-c1	15	25522385	25742804	3.0	cnv_partition	220419
LN511-B5	15	25571675	25716379	3.0	cnv_partition	144704
LN511-C11	15	25584295	25769369	3.0	cnv_partition	185074
LN511-D4	15	25584295	25662525	3.0	cnv_partition	78230
LN521-G11	15	91274575	91346951	3.0	cnv_partition	72376
MG-E3	15	25522385	25748137	3.0	cnv_partition	225752
RD122 80:20_B4	15	25494968	25748137	3.0	cnv_partition	253169
RD122 80:20_B8	15	25494968	25742804	3.0	cnv_partition	247836
AD2	16	2134357	2280865	1.0	cnv_partition	146508
AD3_AZ	16	30212911	30326963	1.0	cnv_partition	114052
AD3_AZ	16	32523490	33772866	1.0	cnv_partition	1249376
AD3_P4	16	30212911	30326963	1.0	cnv_partition	114052
Kolf2-c1	16	53644956	53726025	3.0	cnv_partition	81069
LN511-D4	16	32020021	33772866	1.0	cnv_partition	1752845
LN511-D4	16	53660305	53721875	3.0	cnv_partition	61570
LN521-B2	16	32096969	33772866	1.0	cnv_partition	1675897
LN521-E2	16	32523490	33772866	1.0	cnv_partition	1249376
MG-E3	16	53644956	53784964	3.0	cnv_partition	140008
RD12280:20_C6	16	2134569	2280865	1.0	cnv_partition	146296
AD2	17	63734778	64958351	2.0	cnv_partition	1223573
Kolf2-c1	17	45808828	46863859	2.0	cnv_partition	1055031
LN511-B5	17	59676854	59938865	3.0	cnv_partition	262011
LN511-B5	17	45808828	46863859	2.0	cnv_partition	1055031
LN511-C11	17	2509165	2577412	3.0	cnv_partition	68247
LN511-C11	17	59745806	59938865	3.0	cnv_partition	193059
LN511-C11	17	45808828	46863859	2.0	cnv_partition	1055031
LN511-D4	17	59745806	59938865	3.0	cnv_partition	193059
LN511-D4	17	45808828	46863859	2.0	cnv_partition	1055031
LN511-E5	17	2520420	2577412	3.0	cnv_partition	56992
LN511-E5	17	59745806	59938865	3.0	cnv_partition	193059
LN511-E5	17	45808828	46863859	2.0	cnv_partition	1055031
LN521-B2	17	59745806	59938865	3.0	cnv_partition	193059
LN521-B2	17	45808828	46863859	2.0	cnv_partition	1055031
LN521-E2	17	59745806	59926556	3.0	cnv_partition	180750
LN521-E2	17	45808828	46863859	2.0	cnv_partition	1055031
LN521-F11	17	59745806	59938865	3.0	cnv_partition	193059
LN521-F11	17	45808828	46863859	2.0	cnv_partition	1055031
LN521-G11	17	59676854	59938865	3.0	cnv_partition	262011
LN521-G11	17	45808828	46863859	2.0	cnv_partition	1055031
MG-C11	17	59748454	59938865	3.0	cnv_partition	190411
MG-C11	17	45808828	46863859	2.0	cnv_partition	1055031
MG-D7	17	45808828	46863859	2.0	cnv_partition	1055031
MG-E3	17	2514151	2577412	3.0	cnv_partition	63261
MG-E3	17	59676854	59934481	3.0	cnv_partition	257627
MG-E3	17	45808828	46863859	2.0	cnv_partition	1055031
MG-G5	17	59745806	59938865	3.0	cnv_partition	193059
MG-G5	17	45808828	46863859	2.0	cnv_partition	1055031
RD122 80:20_B1	17	59652288	59938865	3.0	cnv_partition	286577
RD122 80:20_B7	17	59635424	59934481	3.0	cnv_partition	299057
RD122 80:20_B8	17	59652288	59938865	3.0	cnv_partition	286577
RD122 80:20_C4	17	59821932	59926602	3.0	cnv_partition	104670
RD12280:20_C6	17	59567791	59938865	3.0	cnv_partition	371074
Kolf2-c1	18	62138572	62264706	3.0	cnv_partition	126134
LN511-B5	18	62106616	62264706	3.0	cnv_partition	158090
LN511-D4	18	48397264	48604650	3.0	cnv_partition	207386
LN511-D4	18	62106616	62264706	3.0	cnv_partition	158090
LN511-E5	18	62106616	62264706	3.0	cnv_partition	158090
LN521-B2	18	62106616	62264706	3.0	cnv_partition	158090
LN521-E2	18	62138572	62264706	3.0	cnv_partition	126134
LN521-F11	18	62106616	62264706	3.0	cnv_partition	158090
LN521-G11	18	62138572	62264706	3.0	cnv_partition	126134
MG-E3	18	48397264	48603148	3.0	cnv_partition	205884
MG-E3	18	62106616	62279611	3.0	cnv_partition	172995
MG-G5	18	62138572	62279611	3.0	cnv_partition	141039
RD122 80:20_B4	18	59806230	59984682	3.0	cnv_partition	178452
RD122 80:20_B6	18	48397264	48604650	3.0	cnv_partition	207386
RD12280:20_C6	18	48397264	48604650	3.0	cnv_partition	207386
AD2	19	50339605	50393269	1.0	cnv_partition	53664
Kolf2-c1	19	1219342	1302888	1.0	cnv_partition	83546
RD122 80:20_B4	19	50299866	50375101	1.0	cnv_partition	75235
RD122 80:20_B8	19	38931470	39076588	1.0	cnv_partition	145118
RD122 80:20_B8	19	50296145	50394886	1.0	cnv_partition	98741
RD122 80:20_C2	19	50299866	50380858	1.0	cnv_partition	80992
RD12280:20_C6	19	50299866	50375101	1.0	cnv_partition	75235
AD2	2	39216404	39602792	3.0	cnv_partition	386388
AD2	2	47635524	47710541	3.0	cnv_partition	75017
AD2	2	48030825	48300241	3.0	cnv_partition	269416
AD2	2	175572035	176929979	2.0	cnv_partition	1357944
AD3_AZ	2	47635539	47751215	3.0	cnv_partition	115676
AD3_AZ	2	48030825	48300241	3.0	cnv_partition	269416
AD3_P4	2	47635542	47751215	3.0	cnv_partition	115673
Kolf2-c1	2	47635524	47751215	3.0	cnv_partition	115691
Kolf2-c1	2	183449725	184137284	3.0	cnv_partition	687559
Kolf2-c1	2	185389340	186880879	2.0	cnv_partition	1491539
LN511-B5	2	39224112	39602792	3.0	cnv_partition	378680
LN511-B5	2	47635524	47710084	3.0	cnv_partition	74560
LN511-B5	2	48030825	48230978	3.0	cnv_partition	200153
LN511-B5	2	187871643	189872861	3.0	cnv_partition	2001218
LN511-B5	2	185389340	186880879	2.0	cnv_partition	1491539
LN511-C11	2	39216404	39602792	3.0	cnv_partition	386388
LN511-C11	2	47635524	47751215	3.0	cnv_partition	115691
LN511-C11	2	48030825	48230978	3.0	cnv_partition	200153
LN511-C11	2	188033045	189873659	3.0	cnv_partition	1840614
LN511-C11	2	135281133	136830635	2.0	cnv_partition	1549502
LN511-C11	2	185389340	186880879	2.0	cnv_partition	1491539
LN511-D4	2	39216404	39331522	3.0	cnv_partition	115118
LN511-D4	2	47635524	47708589	3.0	cnv_partition	73065
LN511-D4	2	135281133	136830635	2.0	cnv_partition	1549502
LN511-D4	2	185389340	186880879	2.0	cnv_partition	1491539
LN511-E5	2	47635524	47709916	3.0	cnv_partition	74392
LN511-E5	2	135803425	136479698	3.0	cnv_partition	676273
LN511-E5	2	185389340	186880879	2.0	cnv_partition	1491539
LN521-B2	2	39224112	39331522	3.0	cnv_partition	107410
LN521-B2	2	47635542	47751215	3.0	cnv_partition	115673
LN521-B2	2	188131502	189872861	3.0	cnv_partition	1741359
LN521-B2	2	135281133	136830635	2.0	cnv_partition	1549502
LN521-B2	2	185389340	186880879	2.0	cnv_partition	1491539
LN521-E2	2	47635542	47698203	3.0	cnv_partition	62661
LN521-E2	2	48030825	48233949	3.0	cnv_partition	203124
LN521-E2	2	187871643	189872861	3.0	cnv_partition	2001218
LN521-E2	2	185389340	186880879	2.0	cnv_partition	1491539
LN521-F11	2	47635524	47693949	3.0	cnv_partition	58425
LN521-F11	2	188131502	189872861	3.0	cnv_partition	1741359
LN521-F11	2	185389340	186880879	2.0	cnv_partition	1491539
LN521-G11	2	47635524	47709913	3.0	cnv_partition	74389
LN521-G11	2	48030825	48230978	3.0	cnv_partition	200153
LN521-G11	2	166848897	168442147	3.0	cnv_partition	1593250
LN521-G11	2	188145507	189872861	3.0	cnv_partition	1727354
LN521-G11	2	135281133	136830635	2.0	cnv_partition	1549502
LN521-G11	2	185389340	186880879	2.0	cnv_partition	1491539
MG-C11	2	39216404	39602792	3.0	cnv_partition	386388
MG-C11	2	47635524	47751215	3.0	cnv_partition	115691
MG-C11	2	166848897	168442147	3.0	cnv_partition	1593250
MG-C11	2	188131502	189873659	3.0	cnv_partition	1742157
MG-C11	2	135281133	136830635	2.0	cnv_partition	1549502
MG-C11	2	185389340	186880879	2.0	cnv_partition	1491539
MG-D7	2	47635542	47710084	3.0	cnv_partition	74542
MG-D7	2	135281133	136830635	2.0	cnv_partition	1549502
MG-D7	2	185389340	186880879	2.0	cnv_partition	1491539
MG-E3	2	39216404	39331522	3.0	cnv_partition	115118
MG-E3	2	47635524	47751215	3.0	cnv_partition	115691
MG-E3	2	135281133	136830635	2.0	cnv_partition	1549502
MG-E3	2	185389340	186880879	2.0	cnv_partition	1491539
MG-G5	2	47639598	47698203	3.0	cnv_partition	58605
MG-G5	2	48032047	48230978	3.0	cnv_partition	198931
MG-G5	2	185389340	186880879	2.0	cnv_partition	1491539
RD122 80:20_B1	2	47635542	47703501	3.0	cnv_partition	67959
RD122 80:20_B1	2	77043860	77783184	3.0	cnv_partition	739324
RD122 80:20_B1	2	135988235	137902997	2.0	cnv_partition	1914762
RD122 80:20_B1	2	203602207	205062901	2.0	cnv_partition	1460694
RD122 80:20_B4	2	47635542	47702160	3.0	cnv_partition	66618
RD122 80:20_B4	2	135988235	137902997	2.0	cnv_partition	1914762
RD122 80:20_B4	2	203602207	205062901	2.0	cnv_partition	1460694
RD122 80:20_B6	2	47639598	47702411	3.0	cnv_partition	62813
RD122 80:20_B6	2	135988235	137902997	2.0	cnv_partition	1914762
RD122 80:20_B6	2	203602207	205062901	2.0	cnv_partition	1460694
RD122 80:20_B7	2	47635542	47703501	3.0	cnv_partition	67959
RD122 80:20_B7	2	76997763	78827915	3.0	cnv_partition	1830152
RD122 80:20_B7	2	135988235	137902997	2.0	cnv_partition	1914762
RD122 80:20_B7	2	203602207	205062901	2.0	cnv_partition	1460694
RD122 80:20_B8	2	47639598	47703501	3.0	cnv_partition	63903
RD122 80:20_B8	2	135988235	137902997	2.0	cnv_partition	1914762
RD122 80:20_B8	2	203602207	205062901	2.0	cnv_partition	1460694
RD122 80:20_C2	2	47635542	47702163	3.0	cnv_partition	66621
RD122 80:20_C2	2	189853017	191158930	3.0	cnv_partition	1305913
RD122 80:20_C2	2	135988235	137902997	2.0	cnv_partition	1914762
RD122 80:20_C2	2	203602207	205062901	2.0	cnv_partition	1460694
RD122 80:20_C4	2	47639598	47702160	3.0	cnv_partition	62562
RD122 80:20_C4	2	135988235	137902997	2.0	cnv_partition	1914762
RD122 80:20_C4	2	203602207	205062901	2.0	cnv_partition	1460694
RD12280:20_C6	2	47639598	47710084	3.0	cnv_partition	70486
RD12280:20_C6	2	135988235	137902997	2.0	cnv_partition	1914762
RD12280:20_C6	2	203602207	205062901	2.0	cnv_partition	1460694
AD2	20	62084720	62139572	1.0	cnv_partition	54852
AD3_AZ	20	29811475	31885139	3.0	cnv_partition	2073664
AD3_P4	20	29811475	31885139	3.0	cnv_partition	2073664
RD122 80:20_B1	20	29811475	30745269	3.0	cnv_partition	933794
RD122 80:20_B4	20	29811475	30745269	3.0	cnv_partition	933794
RD122 80:20_B6	20	29432371	30745269	3.0	cnv_partition	1312898
RD122 80:20_B7	20	29432371	30980453	3.0	cnv_partition	1548082
RD122 80:20_B8	20	29811475	30745269	3.0	cnv_partition	933794
RD122 80:20_C2	20	29811475	30745269	3.0	cnv_partition	933794
RD122 80:20_C4	20	29432371	30745269	3.0	cnv_partition	1312898
RD12280:20_C6	20	29432371	31003212	3.0	cnv_partition	1570841
AD3_AZ	22	24300611	24377733	1.0	cnv_partition	77122
AD3_AZ	22	33945678	34298354	1.0	cnv_partition	352676
AD3_P4	22	24300635	24379382	1.0	cnv_partition	78747
AD3_P4	22	33945678	34298354	1.0	cnv_partition	352676
AD2	3	118745936	118818656	3.0	cnv_partition	72720
AD3_AZ	3	64729892	65150870	3.0	cnv_partition	420978
AD3_P4	3	64734932	65150083	3.0	cnv_partition	415151
Kolf2-c1	3	61136894	61905527	3.0	cnv_partition	768633
Kolf2-c1	3	72289657	72404542	1.0	cnv_partition	114885
Kolf2-c1	3	132141174	132438660	3.0	cnv_partition	297486
Kolf2-c1	3	55808202	56865776	2.0	cnv_partition	1057574
LN511-B5	3	61047068	61897451	3.0	cnv_partition	850383
LN511-B5	3	72289657	72404542	1.0	cnv_partition	114885
LN511-B5	3	132158769	132491193	3.0	cnv_partition	332424
LN511-B5	3	55808202	56865776	2.0	cnv_partition	1057574
LN511-C11	3	61143949	61973292	3.0	cnv_partition	829343
LN511-C11	3	72289657	72404542	1.0	cnv_partition	114885
LN511-C11	3	55808202	56865776	2.0	cnv_partition	1057574
LN511-D4	3	61145609	61528270	3.0	cnv_partition	382661
LN511-D4	3	72306268	72424795	1.0	cnv_partition	118527
LN511-D4	3	55808202	56865776	2.0	cnv_partition	1057574
LN511-E5	3	61047068	61897451	3.0	cnv_partition	850383
LN511-E5	3	72289657	72404542	1.0	cnv_partition	114885
LN511-E5	3	123558668	123684339	3.0	cnv_partition	125671
LN511-E5	3	55808202	56865776	2.0	cnv_partition	1057574
LN521-B2	3	61143949	61528270	3.0	cnv_partition	384321
LN521-B2	3	72289657	72424795	1.0	cnv_partition	135138
LN521-B2	3	55808202	56865776	2.0	cnv_partition	1057574
LN521-E2	3	61143949	61897451	3.0	cnv_partition	753502
LN521-E2	3	72289657	72424795	1.0	cnv_partition	135138
LN521-E2	3	55808202	56865776	2.0	cnv_partition	1057574
LN521-F11	3	61143949	61528270	3.0	cnv_partition	384321
LN521-F11	3	72289657	72404542	1.0	cnv_partition	114885
LN521-F11	3	55808202	56865776	2.0	cnv_partition	1057574
LN521-G11	3	61143949	61973292	3.0	cnv_partition	829343
LN521-G11	3	72289657	72404542	1.0	cnv_partition	114885
LN521-G11	3	123558668	123684339	3.0	cnv_partition	125671
LN521-G11	3	132213034	132438660	3.0	cnv_partition	225626
LN521-G11	3	55808202	56865776	2.0	cnv_partition	1057574
MG-C11	3	61136894	61973292	3.0	cnv_partition	836398
MG-C11	3	72289657	72424795	1.0	cnv_partition	135138
MG-C11	3	132157429	132438660	3.0	cnv_partition	281231
MG-C11	3	55808202	56865776	2.0	cnv_partition	1057574
MG-D7	3	61136894	61905527	3.0	cnv_partition	768633
MG-D7	3	72289657	72404542	1.0	cnv_partition	114885
MG-D7	3	55808202	56865776	2.0	cnv_partition	1057574
MG-E3	3	61047068	61973292	3.0	cnv_partition	926224
MG-E3	3	72289657	72404542	1.0	cnv_partition	114885
MG-E3	3	123558668	123684339	3.0	cnv_partition	125671
MG-E3	3	132158769	132438660	3.0	cnv_partition	279891
MG-E3	3	55808202	56865776	2.0	cnv_partition	1057574
MG-G5	3	61136894	61897451	3.0	cnv_partition	760557
MG-G5	3	72289657	72424795	1.0	cnv_partition	135138
MG-G5	3	55808202	56865776	2.0	cnv_partition	1057574
RD122 80:20_B1	3	123558668	123684339	3.0	cnv_partition	125671
RD122 80:20_B1	3	43618202	44880294	2.0	cnv_partition	1262092
RD122 80:20_B4	3	43618202	44880294	2.0	cnv_partition	1262092
RD122 80:20_B6	3	43618202	44880294	2.0	cnv_partition	1262092
RD122 80:20_B8	3	43618202	44880294	2.0	cnv_partition	1262092
RD122 80:20_C2	3	43618202	44880294	2.0	cnv_partition	1262092
RD122 80:20_C4	3	43618202	44880294	2.0	cnv_partition	1262092
RD12280:20_C6	3	43618202	44880294	2.0	cnv_partition	1262092
AD2	4	958274	1020882	0.0	cnv_partition	62608
AD2	4	1786702	1893167	1.0	cnv_partition	106465
Kolf2-c1	4	69430742	69531327	3.0	cnv_partition	100585
Kolf2-c1	4	101194725	102227246	2.0	cnv_partition	1032521
LN511-B5	4	70289417	70672152	3.0	cnv_partition	382735
LN511-B5	4	101194725	102227246	2.0	cnv_partition	1032521
LN511-C11	4	70289417	70600199	3.0	cnv_partition	310782
LN511-C11	4	101194725	102227246	2.0	cnv_partition	1032521
LN511-D4	4	70289417	70723681	3.0	cnv_partition	434264
LN511-D4	4	101194725	102227246	2.0	cnv_partition	1032521
LN511-E5	4	69430742	69531327	3.0	cnv_partition	100585
LN511-E5	4	101194725	102227246	2.0	cnv_partition	1032521
LN521-B2	4	70354534	70600440	3.0	cnv_partition	245906
LN521-B2	4	101194725	102227246	2.0	cnv_partition	1032521
LN521-E2	4	69430742	69531327	3.0	cnv_partition	100585
LN521-E2	4	101194725	102227246	2.0	cnv_partition	1032521
LN521-F11	4	70348090	70600199	3.0	cnv_partition	252109
LN521-F11	4	101194725	102227246	2.0	cnv_partition	1032521
LN521-G11	4	69430742	69531327	3.0	cnv_partition	100585
LN521-G11	4	101194725	102227246	2.0	cnv_partition	1032521
MG-C11	4	69430742	69531327	3.0	cnv_partition	100585
MG-C11	4	101194725	102227246	2.0	cnv_partition	1032521
MG-D7	4	69430742	69530098	3.0	cnv_partition	99356
MG-D7	4	101194725	102227246	2.0	cnv_partition	1032521
MG-E3	4	70289417	70723681	3.0	cnv_partition	434264
MG-E3	4	101194725	102227246	2.0	cnv_partition	1032521
MG-G5	4	101194725	102227246	2.0	cnv_partition	1032521
RD122 80:20_B1	4	134157609	135806434	2.0	cnv_partition	1648825
RD122 80:20_B4	4	134157609	135806434	2.0	cnv_partition	1648825
RD122 80:20_B6	4	134157609	135806434	2.0	cnv_partition	1648825
RD122 80:20_B7	4	90958245	93553252	3.0	cnv_partition	2595007
RD122 80:20_B7	4	134157609	135806434	2.0	cnv_partition	1648825
RD122 80:20_B8	4	134157609	135806434	2.0	cnv_partition	1648825
RD122 80:20_C2	4	134157609	135806434	2.0	cnv_partition	1648825
RD122 80:20_C4	4	134157609	135806434	2.0	cnv_partition	1648825
RD12280:20_C6	4	134157609	135806434	2.0	cnv_partition	1648825
AD2	5	36986184	37272728	3.0	cnv_partition	286544
AD2	5	112090601	112170636	3.0	cnv_partition	80035
AD3_AZ	5	112068338	112164670	3.0	cnv_partition	96332
AD3_P4	5	112090601	112164558	3.0	cnv_partition	73957
Kolf2-c1	5	36805679	37272728	3.0	cnv_partition	467049
Kolf2-c1	5	112090601	112170636	3.0	cnv_partition	80035
LN511-B5	5	36764235	37751724	3.0	cnv_partition	987489
LN511-B5	5	112086874	112164558	3.0	cnv_partition	77684
LN511-B5	5	133026901	133233507	3.0	cnv_partition	206606
LN511-C11	5	36764235	37272728	3.0	cnv_partition	508493
LN511-C11	5	112111439	112170636	3.0	cnv_partition	59197
LN511-D4	5	36986184	37272728	3.0	cnv_partition	286544
LN511-E5	5	36986184	37418713	3.0	cnv_partition	432529
LN511-E5	5	112090601	112164558	3.0	cnv_partition	73957
LN521-B2	5	36911625	37568411	3.0	cnv_partition	656786
LN521-B2	5	112086874	112170636	3.0	cnv_partition	83762
LN521-E2	5	36986184	37272728	3.0	cnv_partition	286544
LN521-E2	5	112090601	112170636	3.0	cnv_partition	80035
LN521-F11	5	36764235	37272728	3.0	cnv_partition	508493
LN521-F11	5	112090601	112170636	3.0	cnv_partition	80035
LN521-G11	5	36986184	37418713	3.0	cnv_partition	432529
LN521-G11	5	112090601	112170682	3.0	cnv_partition	80081
MG-C11	5	36986184	37418713	3.0	cnv_partition	432529
MG-C11	5	112111439	112170636	3.0	cnv_partition	59197
MG-D7	5	36986184	37751724	3.0	cnv_partition	765540
MG-D7	5	112090601	112170636	3.0	cnv_partition	80035
MG-E3	5	36898424	37294473	3.0	cnv_partition	396049
MG-E3	5	112111439	112170636	3.0	cnv_partition	59197
MG-E3	5	131915005	131977907	3.0	cnv_partition	62902
MG-G5	5	36986184	37272728	3.0	cnv_partition	286544
MG-G5	5	112090601	112170636	3.0	cnv_partition	80035
RD122 80:20_B1	5	36759602	37418713	3.0	cnv_partition	659111
RD122 80:20_B1	5	112090601	112164557	3.0	cnv_partition	73956
RD122 80:20_B4	5	36764235	37568411	3.0	cnv_partition	804176
RD122 80:20_B4	5	112090601	112163704	3.0	cnv_partition	73103
RD122 80:20_B6	5	36986184	37418713	3.0	cnv_partition	432529
RD122 80:20_B6	5	112090601	112164557	3.0	cnv_partition	73956
RD122 80:20_B7	5	36986184	37294473	3.0	cnv_partition	308289
RD122 80:20_B7	5	131840396	131977907	3.0	cnv_partition	137511
RD122 80:20_B8	5	36764235	37304547	3.0	cnv_partition	540312
RD122 80:20_B8	5	112086874	112164557	3.0	cnv_partition	77683
RD122 80:20_C2	5	36764235	37418713	3.0	cnv_partition	654478
RD122 80:20_C2	5	45906203	46313227	3.0	cnv_partition	407024
RD122 80:20_C2	5	131902931	131977907	3.0	cnv_partition	74976
RD122 80:20_C4	5	36764235	37568411	3.0	cnv_partition	804176
RD122 80:20_C4	5	112090601	112164557	3.0	cnv_partition	73956
RD12280:20_C6	5	36764235	37568411	3.0	cnv_partition	804176
RD12280:20_C6	5	112086874	112164557	3.0	cnv_partition	77683
Kolf2-c1	6	15487649	15722102	1.0	cnv_partition	234453
Kolf2-c1	6	42672100	43685195	2.0	cnv_partition	1013095
LN511-B5	6	15487649	15739843	1.0	cnv_partition	252194
LN511-B5	6	42672100	43685195	2.0	cnv_partition	1013095
LN511-C11	6	15487649	15722102	1.0	cnv_partition	234453
LN511-C11	6	48899040	49425764	3.0	cnv_partition	526724
LN511-C11	6	42672100	43685195	2.0	cnv_partition	1013095
LN511-D4	6	15487649	15739843	1.0	cnv_partition	252194
LN511-D4	6	42672100	43685195	2.0	cnv_partition	1013095
LN511-E5	6	15487649	15722102	1.0	cnv_partition	234453
LN511-E5	6	42672100	43685195	2.0	cnv_partition	1013095
LN521-B2	6	15487649	15722102	1.0	cnv_partition	234453
LN521-B2	6	42672100	43685195	2.0	cnv_partition	1013095
LN521-E2	6	15487649	15722102	1.0	cnv_partition	234453
LN521-E2	6	18129722	18190435	3.0	cnv_partition	60713
LN521-E2	6	42672100	43685195	2.0	cnv_partition	1013095
LN521-F11	6	15487649	15722102	1.0	cnv_partition	234453
LN521-F11	6	42672100	43685195	2.0	cnv_partition	1013095
LN521-G11	6	15487649	15734884	1.0	cnv_partition	247235
LN521-G11	6	18129722	18190435	3.0	cnv_partition	60713
LN521-G11	6	42672100	43685195	2.0	cnv_partition	1013095
MG-C11	6	15487649	15722102	1.0	cnv_partition	234453
MG-C11	6	49046961	49425764	3.0	cnv_partition	378803
MG-C11	6	42672100	43685195	2.0	cnv_partition	1013095
MG-D7	6	15487649	15722102	1.0	cnv_partition	234453
MG-D7	6	42672100	43685195	2.0	cnv_partition	1013095
MG-E3	6	15487649	15739843	1.0	cnv_partition	252194
MG-E3	6	42672100	43685195	2.0	cnv_partition	1013095
MG-G5	6	15487649	15722102	1.0	cnv_partition	234453
MG-G5	6	42672100	43685195	2.0	cnv_partition	1013095
RD122 80:20_B6	6	5571672	5632371	1.0	cnv_partition	60699
RD122 80:20_B8	6	5571672	5632371	1.0	cnv_partition	60699
AD2	7	117130915	117305620	3.0	cnv_partition	174705
AD3_AZ	7	9066820	9127173	1.0	cnv_partition	60353
Kolf2-c1	7	20731918	20823569	3.0	cnv_partition	91651
Kolf2-c1	7	117227785	117292959	3.0	cnv_partition	65174
Kolf2-c1	7	140417863	140517444	3.0	cnv_partition	99581
LN511-B5	7	91565644	92326346	3.0	cnv_partition	760702
LN511-B5	7	117227785	117292959	3.0	cnv_partition	65174
LN511-B5	7	140394547	140569676	3.0	cnv_partition	175129
LN511-C11	7	117130915	117292957	3.0	cnv_partition	162042
LN511-C11	7	140439727	140569676	3.0	cnv_partition	129949
LN511-D4	7	117142898	117292959	3.0	cnv_partition	150061
LN511-D4	7	140417863	140569676	3.0	cnv_partition	151813
LN511-E5	7	117142898	117305619	3.0	cnv_partition	162721
LN521-B2	7	117142898	117305620	3.0	cnv_partition	162722
LN521-E2	7	117171169	117305620	3.0	cnv_partition	134451
LN521-F11	7	20732726	20815352	3.0	cnv_partition	82626
LN521-F11	7	117142898	117292957	3.0	cnv_partition	150059
LN521-F11	7	140394547	140517444	3.0	cnv_partition	122897
LN521-G11	7	117175417	117292959	3.0	cnv_partition	117542
LN521-G11	7	140453192	140569676	3.0	cnv_partition	116484
MG-C11	7	117142898	117292959	3.0	cnv_partition	150061
MG-C11	7	140417863	140544969	3.0	cnv_partition	127106
MG-D7	7	20732726	20819770	3.0	cnv_partition	87044
MG-D7	7	117130915	117292959	3.0	cnv_partition	162044
MG-D7	7	140454006	140517444	3.0	cnv_partition	63438
MG-E3	7	117142898	117290010	3.0	cnv_partition	147112
MG-E3	7	140417863	140569676	3.0	cnv_partition	151813
MG-G5	7	117144332	117305620	3.0	cnv_partition	161288
RD122 80:20_B1	7	65436108	65579838	1.0	cnv_partition	143730
RD122 80:20_B7	7	65436108	65557801	1.0	cnv_partition	121693
RD122 80:20_B8	7	65436108	65557801	1.0	cnv_partition	121693
RD122 80:20_B8	7	117227785	117291132	3.0	cnv_partition	63347
RD122 80:20_C2	7	65436108	65579838	1.0	cnv_partition	143730
RD122 80:20_C2	7	117143602	117232518	3.0	cnv_partition	88916
RD122 80:20_C2	7	128475604	128562578	1.0	cnv_partition	86974
RD12280:20_C6	7	65436108	65557801	1.0	cnv_partition	121693
RD12280:20_C6	7	128415195	128562578	1.0	cnv_partition	147383
AD2	8	145541626	145750506	1.0	cnv_partition	208880
AD2	8	66156258	67188281	2.0	cnv_partition	1032023
AD3_AZ	8	83722343	84736331	2.0	cnv_partition	1013988
AD3_P4	8	83722343	84736331	2.0	cnv_partition	1013988
LN511-D4	8	94768027	94821362	3.0	cnv_partition	53335
RD122 80:20_B1	8	137727375	137855721	1.0	cnv_partition	128346
RD122 80:20_B4	8	137770311	137855721	1.0	cnv_partition	85410
RD122 80:20_B6	8	137734805	137855721	1.0	cnv_partition	120916
RD122 80:20_B7	8	50755689	51558988	3.0	cnv_partition	803299
RD122 80:20_B8	8	137770311	137855721	1.0	cnv_partition	85410
RD122 80:20_C4	8	137727375	137855721	1.0	cnv_partition	128346
AD2	9	106483432	106725673	1.0	cnv_partition	242241
AD2	9	139904658	140188578	1.0	cnv_partition	283920
AD3_AZ	9	113639333	114831484	2.0	cnv_partition	1192151
AD3_P4	9	113639333	114831484	2.0	cnv_partition	1192151
Kolf2-c1	9	119244942	119355584	1.0	cnv_partition	110642
LN521-E2	9	119244942	119355584	1.0	cnv_partition	110642
MG-C11	9	119244942	119345414	1.0	cnv_partition	100472
MG-D7	9	119244942	119355584	1.0	cnv_partition	110642
MG-E3	9	119244942	119355584	1.0	cnv_partition	110642
MG-G5	9	119244942	119355584	1.0	cnv_partition	110642
