chr	start	end	cnv	sample_id	value	cnv_algorithm	size
1	838555	1227897	1.0	AD2	26.68	penn_cnv	389342
1	98157332	98502934	3.0	RD122 80:20_B7	14.273	penn_cnv	345602
1	17305903	17540345	1.0	RD122 80:20_C2	14.186	penn_cnv	234442
2	79001780	79198168	3.0	RD122 80:20_B7	15.613	penn_cnv	196388
3	64755337	65054400	3.0	AD3_AZ	27.16	penn_cnv	299063
3	13053937	13144375	1.0	AD3_P4	11.979	penn_cnv	90438
3	64755337	65054400	3.0	AD3_P4	33.351	penn_cnv	299063
3	72291638	72403467	1.0	Kolf2-c1	48.407	penn_cnv	111829
3	72291638	72403467	1.0	LN511-B5	38.192	penn_cnv	111829
3	61238218	61567988	3.0	LN511-B5	19.131	penn_cnv	329770
3	72291638	72403467	1.0	LN511-C11	39.112	penn_cnv	111829
3	61238218	61567988	3.0	LN511-C11	18.432	penn_cnv	329770
3	72291638	72403467	1.0	LN511-D4	38.399	penn_cnv	111829
3	61238218	61567988	3.0	LN511-D4	17.444	penn_cnv	329770
3	72291638	72403467	1.0	LN511-E5	37.772	penn_cnv	111829
3	72291638	72403467	1.0	LN521-B2	34.878	penn_cnv	111829
3	61238218	61567988	3.0	LN521-B2	21.556	penn_cnv	329770
3	72291638	72403467	1.0	LN521-E2	41.629	penn_cnv	111829
3	61238218	61567988	3.0	LN521-E2	20.941	penn_cnv	329770
3	72291638	72403467	1.0	LN521-F11	35.256	penn_cnv	111829
3	72291638	72403467	1.0	LN521-G11	30.299	penn_cnv	111829
3	72310765	72403467	1.0	MG-C11	39.978	penn_cnv	92702
3	72291638	72403467	1.0	MG-D7	41.527	penn_cnv	111829
3	61238218	61639764	3.0	MG-D7	21.724	penn_cnv	401546
3	72291638	72403467	1.0	MG-E3	36.382	penn_cnv	111829
3	72291638	72403467	1.0	MG-G5	41.491	penn_cnv	111829
3	61238218	61567988	3.0	MG-G5	24.377	penn_cnv	329770
3	79077887	79493603	3.0	RD122 80:20_B7	9.282	penn_cnv	415716
6	15499419	15739843	1.0	MG-G5	16.824	penn_cnv	240424
6	5571672	5632356	1.0	RD122 80:20_B8	16.103	penn_cnv	60684
6	33135962	33283766	1.0	RD122 80:20_B8	16.501	penn_cnv	147804
6	33135962	33283766	1.0	RD122 80:20_C2	15.805	penn_cnv	147804
6	5571672	5632356	1.0	RD12280:20_C6	12.14	penn_cnv	60684
8	21884544	22025644	1.0	AD2	18.985	penn_cnv	141100
8	145567056	145738669	1.0	AD2	24.475	penn_cnv	171613
8	144963266	145072539	1.0	RD122 80:20_B1	15.345	penn_cnv	109273
8	144963266	145072539	1.0	RD122 80:20_B4	12.275	penn_cnv	109273
8	144620183	145155408	1.0	RD122 80:20_B8	28.365	penn_cnv	535225
8	144620183	145072539	1.0	RD122 80:20_C2	30.817	penn_cnv	452356
8	144963266	145072539	1.0	RD122 80:20_C4	14.514	penn_cnv	109273
8	144620183	145072539	1.0	RD12280:20_C6	17.273	penn_cnv	452356
10	61722273	61831271	3.0	RD122 80:20_B7	11.91	penn_cnv	108998
11	1298430	1491096	1.0	AD2	16.054	penn_cnv	192666
11	828784	884543	1.0	RD122 80:20_B1	12.837	penn_cnv	55759
11	825110	884543	1.0	RD122 80:20_B8	18.049	penn_cnv	59433
11	825110	884543	1.0	RD122 80:20_C2	15.87	penn_cnv	59433
14	105555396	105961529	1.0	AD2	27.383	penn_cnv	406133
16	335373	845819	1.0	AD2	38.992	penn_cnv	510446
18	62133107	62229526	3.0	Kolf2-c1	15.581	penn_cnv	96419
18	62133107	62229526	3.0	LN511-C11	11.563	penn_cnv	96419
18	40404217	40646176	3.0	LN511-E5	8.597	penn_cnv	241959
18	62133107	62229526	3.0	LN521-B2	15.11	penn_cnv	96419
18	40404217	40646176	3.0	LN521-E2	11.123	penn_cnv	241959
18	62133107	62229526	3.0	LN521-G11	12.343	penn_cnv	96419
18	40404217	40646176	3.0	MG-C11	8.457	penn_cnv	241959
18	62133107	62229526	3.0	MG-C11	13.345	penn_cnv	96419
18	62133107	62229526	3.0	MG-E3	9.281	penn_cnv	96419
18	62133107	62229526	3.0	MG-G5	16.28	penn_cnv	96419
18	26618345	26881864	3.0	RD122 80:20_B7	12.071	penn_cnv	263519
19	850023	1046520	1.0	AD2	35.794	penn_cnv	196497
19	3579481	3698333	1.0	AD2	14.584	penn_cnv	118852
20	30643595	31494382	3.0	AD3_AZ	62.416	penn_cnv	850787
20	30643595	31511702	3.0	AD3_P4	66.069	penn_cnv	868107
20	30511108	30745269	3.0	RD122 80:20_B1	22.179	penn_cnv	234161
20	30511108	30745269	3.0	RD122 80:20_B4	27.821	penn_cnv	234161
20	30511108	30745269	3.0	RD122 80:20_B6	32.693	penn_cnv	234161
20	30511108	30745269	3.0	RD122 80:20_B7	21.138	penn_cnv	234161
20	30511108	30745269	3.0	RD122 80:20_B8	28.052	penn_cnv	234161
20	30511108	30745269	3.0	RD122 80:20_C2	24.767	penn_cnv	234161
20	30511108	30745269	3.0	RD122 80:20_C4	25.244	penn_cnv	234161
20	30511108	30745269	3.0	RD12280:20_C6	25.498	penn_cnv	234161
22	50601063	50754363	1.0	AD2	22.726	penn_cnv	153300
22	33950537	34277434	1.0	AD3_AZ	55.277	penn_cnv	326897
22	33950537	34277434	1.0	AD3_P4	64.064	penn_cnv	326897
1	154767834	156206695		AD3_AZ	2.0	cnv_partition	1438861
1	177938243	178954089		AD3_AZ	2.0	cnv_partition	1015846
1	154767834	156206695		AD3_P4	2.0	cnv_partition	1438861
1	177938243	178954089		AD3_P4	2.0	cnv_partition	1015846
1	100314969	100709949		Kolf2-c1	3.0	cnv_partition	394980
1	62908386	63201577		LN511-B5	3.0	cnv_partition	293191
1	100314969	100709949		LN511-B5	3.0	cnv_partition	394980
1	100314969	100709949		LN511-C11	3.0	cnv_partition	394980
1	97746924	98528798		LN511-D4	3.0	cnv_partition	781874
1	100314969	100709949		LN511-D4	3.0	cnv_partition	394980
1	62908386	63266810		LN511-E5	3.0	cnv_partition	358424
1	100314969	100706416		LN511-E5	3.0	cnv_partition	391447
1	100314969	100709949		LN521-B2	3.0	cnv_partition	394980
1	100314969	100709949		LN521-F11	3.0	cnv_partition	394980
1	57090886	57241234		LN521-G11	3.0	cnv_partition	150348
1	62908386	63201577		MG-C11	3.0	cnv_partition	293191
1	100314969	100709949		MG-C11	3.0	cnv_partition	394980
1	235332555	235457560		MG-C11	3.0	cnv_partition	125005
1	100314969	100709949		MG-D7	3.0	cnv_partition	394980
1	62908386	63282546		MG-E3	3.0	cnv_partition	374160
1	100314969	100709949		MG-G5	3.0	cnv_partition	394980
1	6504654	6560493		RD122 80:20_B4	1.0	cnv_partition	55839
1	156084712	156169610		RD122 80:20_B7	1.0	cnv_partition	84898
1	194270976	197061171		RD122 80:20_B7	3.0	cnv_partition	2790195
1	156035717	156130722		RD122 80:20_B8	1.0	cnv_partition	95005
10	89625234	89692793		AD2	3.0	cnv_partition	67559
10	36905424	39150257		AD2	2.0	cnv_partition	2244833
10	89625234	89692793		AD3_AZ	3.0	cnv_partition	67559
10	89625234	89692793		AD3_P4	3.0	cnv_partition	67559
10	89630424	89692800		Kolf2-c1	3.0	cnv_partition	62376
10	89625234	89692794		LN511-B5	3.0	cnv_partition	67560
10	89625234	89692793		LN511-C11	3.0	cnv_partition	67559
10	89625234	89692794		LN511-D4	3.0	cnv_partition	67560
10	89625234	89692794		LN511-E5	3.0	cnv_partition	67560
10	89625234	89692794		LN521-B2	3.0	cnv_partition	67560
10	89625234	89692794		LN521-E2	3.0	cnv_partition	67560
10	89625234	89692800		LN521-F11	3.0	cnv_partition	67566
10	89625234	89692800		LN521-G11	3.0	cnv_partition	67566
10	89625234	89692794		MG-C11	3.0	cnv_partition	67560
10	89625234	89692793		MG-D7	3.0	cnv_partition	67559
10	89630424	89692794		MG-E3	3.0	cnv_partition	62370
10	89625234	89692794		MG-G5	3.0	cnv_partition	67560
10	89625234	89692800		RD122 80:20_B1	3.0	cnv_partition	67566
10	89625234	89692793		RD122 80:20_B4	3.0	cnv_partition	67559
10	89625234	89692794		RD122 80:20_B6	3.0	cnv_partition	67560
10	89625234	89692800		RD122 80:20_B7	3.0	cnv_partition	67566
10	89625234	89692794		RD122 80:20_B8	3.0	cnv_partition	67560
10	89625234	89692793		RD122 80:20_C2	3.0	cnv_partition	67559
10	89625234	89692793		RD122 80:20_C4	3.0	cnv_partition	67559
10	89625234	89692794		RD12280:20_C6	3.0	cnv_partition	67560
11	64494827	64590854		AD2	1.0	cnv_partition	96027
11	107904913	108218004		AD2	3.0	cnv_partition	313091
11	27510830	28574576		AD3_AZ	2.0	cnv_partition	1063746
11	27510830	28574576		AD3_P4	2.0	cnv_partition	1063746
11	107917087	108218004		Kolf2-c1	3.0	cnv_partition	300917
11	107904913	108218004		LN511-B5	3.0	cnv_partition	313091
11	107904913	108218004		LN511-C11	3.0	cnv_partition	313091
11	107904913	108218004		LN511-D4	3.0	cnv_partition	313091
11	107904913	108218004		LN511-E5	3.0	cnv_partition	313091
11	107917087	108218004		LN521-B2	3.0	cnv_partition	300917
11	108009736	108218004		LN521-E2	3.0	cnv_partition	208268
11	107904913	108216596		LN521-F11	3.0	cnv_partition	311683
11	107904913	108216545		LN521-G11	3.0	cnv_partition	311632
11	107917087	108218004		MG-C11	3.0	cnv_partition	300917
11	107903818	108218004		MG-D7	3.0	cnv_partition	314186
11	108009736	108218004		MG-E3	3.0	cnv_partition	208268
11	107917087	108218004		MG-G5	3.0	cnv_partition	300917
11	47353422	47470476		RD122 80:20_B1	1.0	cnv_partition	117054
11	108012415	108218004		RD122 80:20_B1	3.0	cnv_partition	205589
11	84371220	85837369		RD122 80:20_B1	2.0	cnv_partition	1466149
11	47353422	47470476		RD122 80:20_B4	1.0	cnv_partition	117054
11	107904913	108218004		RD122 80:20_B4	3.0	cnv_partition	313091
11	84371220	85837369		RD122 80:20_B4	2.0	cnv_partition	1466149
11	108012037	108202172		RD122 80:20_B6	3.0	cnv_partition	190135
11	84371220	85837369		RD122 80:20_B6	2.0	cnv_partition	1466149
11	108012415	108216616		RD122 80:20_B7	3.0	cnv_partition	204201
11	84371220	85837369		RD122 80:20_B7	2.0	cnv_partition	1466149
11	76751147	76925653		RD122 80:20_B8	1.0	cnv_partition	174506
11	107904913	108218004		RD122 80:20_B8	3.0	cnv_partition	313091
11	84371220	85837369		RD122 80:20_B8	2.0	cnv_partition	1466149
11	47350287	47470476		RD122 80:20_C2	1.0	cnv_partition	120189
11	108012415	108218004		RD122 80:20_C2	3.0	cnv_partition	205589
11	84371220	85837369		RD122 80:20_C2	2.0	cnv_partition	1466149
11	47353422	47470476		RD122 80:20_C4	1.0	cnv_partition	117054
11	108012415	108216596		RD122 80:20_C4	3.0	cnv_partition	204181
11	84371220	85837369		RD122 80:20_C4	2.0	cnv_partition	1466149
11	64520597	64577603		RD12280:20_C6	1.0	cnv_partition	57006
11	107904913	108216616		RD12280:20_C6	3.0	cnv_partition	311703
11	84371220	85837369		RD12280:20_C6	2.0	cnv_partition	1466149
12	79072373	81091064		LN511-E5	3.0	cnv_partition	2018691
12	77946801	81091064		MG-E3	3.0	cnv_partition	3144263
12	84852873	88555491		MG-E3	3.0	cnv_partition	3702618
12	85232076	87671750		RD122 80:20_B4	3.0	cnv_partition	2439674
12	85928034	87185603		RD122 80:20_B6	3.0	cnv_partition	1257569
12	85243681	87281456		RD122 80:20_C2	3.0	cnv_partition	2037775
13	48908860	49027250		AD2	3.0	cnv_partition	118390
13	48916747	49027249		AD3_P4	3.0	cnv_partition	110502
13	48881489	49039169		Kolf2-c1	3.0	cnv_partition	157680
13	48908860	49027250		LN511-B5	3.0	cnv_partition	118390
13	48908860	49039248		LN511-C11	3.0	cnv_partition	130388
13	32912177	32979138		LN511-D4	3.0	cnv_partition	66961
13	48908860	49039248		LN511-D4	3.0	cnv_partition	130388
13	32912177	32968918		LN511-E5	3.0	cnv_partition	56741
13	48908860	49039252		LN511-E5	3.0	cnv_partition	130392
13	48881489	49039252		LN521-B2	3.0	cnv_partition	157763
13	32912150	32971071		LN521-E2	3.0	cnv_partition	58921
13	48881495	49039166		LN521-E2	3.0	cnv_partition	157671
13	32912150	32976358		LN521-F11	3.0	cnv_partition	64208
13	48908860	49027250		LN521-F11	3.0	cnv_partition	118390
13	48908860	49029385		LN521-G11	3.0	cnv_partition	120525
13	48881489	49039248		MG-C11	3.0	cnv_partition	157759
13	32912150	32972367		MG-D7	3.0	cnv_partition	60217
13	48908860	49039169		MG-D7	3.0	cnv_partition	130309
13	32912166	32971071		MG-E3	3.0	cnv_partition	58905
13	48900988	49039248		MG-E3	3.0	cnv_partition	138260
13	96425265	96707990		MG-E3	3.0	cnv_partition	282725
13	32912150	32971114		MG-G5	3.0	cnv_partition	58964
13	48881495	49027250		MG-G5	3.0	cnv_partition	145755
13	32912166	32983250		RD122 80:20_B1	3.0	cnv_partition	71084
13	48916747	49027249		RD122 80:20_B1	3.0	cnv_partition	110502
13	32890622	32979138		RD122 80:20_B4	3.0	cnv_partition	88516
13	48900988	49027249		RD122 80:20_B4	3.0	cnv_partition	126261
13	48916747	49027249		RD122 80:20_B6	3.0	cnv_partition	110502
13	32912177	33339178		RD122 80:20_B7	3.0	cnv_partition	427001
13	48916747	49027249		RD122 80:20_B7	3.0	cnv_partition	110502
13	32890627	33370859		RD122 80:20_B8	3.0	cnv_partition	480232
13	48881489	49029385		RD122 80:20_B8	3.0	cnv_partition	147896
13	32903564	33370859		RD122 80:20_C2	3.0	cnv_partition	467295
13	48908860	49027250		RD122 80:20_C2	3.0	cnv_partition	118390
13	48881489	49027250		RD122 80:20_C4	3.0	cnv_partition	145761
13	32912166	33351016		RD12280:20_C6	3.0	cnv_partition	438850
13	48916747	49029385		RD12280:20_C6	3.0	cnv_partition	112638
14	67300549	67563593		MG-E3	3.0	cnv_partition	263044
14	67300549	67563593		RD122 80:20_B7	3.0	cnv_partition	263044
15	22321690	22463534		AD2	1.0	cnv_partition	141844
15	91274575	91346951		AD2	3.0	cnv_partition	72376
15	41210356	42264135		AD2	2.0	cnv_partition	1053779
15	25522385	25742804		Kolf2-c1	3.0	cnv_partition	220419
15	25571675	25716379		LN511-B5	3.0	cnv_partition	144704
15	25584295	25769369		LN511-C11	3.0	cnv_partition	185074
15	25584295	25662525		LN511-D4	3.0	cnv_partition	78230
15	91274575	91346951		LN521-G11	3.0	cnv_partition	72376
15	25522385	25748137		MG-E3	3.0	cnv_partition	225752
15	25494968	25748137		RD122 80:20_B4	3.0	cnv_partition	253169
15	25494968	25742804		RD122 80:20_B8	3.0	cnv_partition	247836
16	2134357	2280865		AD2	1.0	cnv_partition	146508
16	30212911	30326963		AD3_AZ	1.0	cnv_partition	114052
16	32523490	33772866		AD3_AZ	1.0	cnv_partition	1249376
16	30212911	30326963		AD3_P4	1.0	cnv_partition	114052
16	53644956	53726025		Kolf2-c1	3.0	cnv_partition	81069
16	32020021	33772866		LN511-D4	1.0	cnv_partition	1752845
16	53660305	53721875		LN511-D4	3.0	cnv_partition	61570
16	32096969	33772866		LN521-B2	1.0	cnv_partition	1675897
16	32523490	33772866		LN521-E2	1.0	cnv_partition	1249376
16	53644956	53784964		MG-E3	3.0	cnv_partition	140008
16	2134569	2280865		RD12280:20_C6	1.0	cnv_partition	146296
17	63734778	64958351		AD2	2.0	cnv_partition	1223573
17	45808828	46863859		Kolf2-c1	2.0	cnv_partition	1055031
17	59676854	59938865		LN511-B5	3.0	cnv_partition	262011
17	45808828	46863859		LN511-B5	2.0	cnv_partition	1055031
17	2509165	2577412		LN511-C11	3.0	cnv_partition	68247
17	59745806	59938865		LN511-C11	3.0	cnv_partition	193059
17	45808828	46863859		LN511-C11	2.0	cnv_partition	1055031
17	59745806	59938865		LN511-D4	3.0	cnv_partition	193059
17	45808828	46863859		LN511-D4	2.0	cnv_partition	1055031
17	2520420	2577412		LN511-E5	3.0	cnv_partition	56992
17	59745806	59938865		LN511-E5	3.0	cnv_partition	193059
17	45808828	46863859		LN511-E5	2.0	cnv_partition	1055031
17	59745806	59938865		LN521-B2	3.0	cnv_partition	193059
17	45808828	46863859		LN521-B2	2.0	cnv_partition	1055031
17	59745806	59926556		LN521-E2	3.0	cnv_partition	180750
17	45808828	46863859		LN521-E2	2.0	cnv_partition	1055031
17	59745806	59938865		LN521-F11	3.0	cnv_partition	193059
17	45808828	46863859		LN521-F11	2.0	cnv_partition	1055031
17	59676854	59938865		LN521-G11	3.0	cnv_partition	262011
17	45808828	46863859		LN521-G11	2.0	cnv_partition	1055031
17	59748454	59938865		MG-C11	3.0	cnv_partition	190411
17	45808828	46863859		MG-C11	2.0	cnv_partition	1055031
17	45808828	46863859		MG-D7	2.0	cnv_partition	1055031
17	2514151	2577412		MG-E3	3.0	cnv_partition	63261
17	59676854	59934481		MG-E3	3.0	cnv_partition	257627
17	45808828	46863859		MG-E3	2.0	cnv_partition	1055031
17	59745806	59938865		MG-G5	3.0	cnv_partition	193059
17	45808828	46863859		MG-G5	2.0	cnv_partition	1055031
17	59652288	59938865		RD122 80:20_B1	3.0	cnv_partition	286577
17	59635424	59934481		RD122 80:20_B7	3.0	cnv_partition	299057
17	59652288	59938865		RD122 80:20_B8	3.0	cnv_partition	286577
17	59821932	59926602		RD122 80:20_C4	3.0	cnv_partition	104670
17	59567791	59938865		RD12280:20_C6	3.0	cnv_partition	371074
18	62138572	62264706		Kolf2-c1	3.0	cnv_partition	126134
18	62106616	62264706		LN511-B5	3.0	cnv_partition	158090
18	48397264	48604650		LN511-D4	3.0	cnv_partition	207386
18	62106616	62264706		LN511-D4	3.0	cnv_partition	158090
18	62106616	62264706		LN511-E5	3.0	cnv_partition	158090
18	62106616	62264706		LN521-B2	3.0	cnv_partition	158090
18	62138572	62264706		LN521-E2	3.0	cnv_partition	126134
18	62106616	62264706		LN521-F11	3.0	cnv_partition	158090
18	62138572	62264706		LN521-G11	3.0	cnv_partition	126134
18	48397264	48603148		MG-E3	3.0	cnv_partition	205884
18	62106616	62279611		MG-E3	3.0	cnv_partition	172995
18	62138572	62279611		MG-G5	3.0	cnv_partition	141039
18	59806230	59984682		RD122 80:20_B4	3.0	cnv_partition	178452
18	48397264	48604650		RD122 80:20_B6	3.0	cnv_partition	207386
18	48397264	48604650		RD12280:20_C6	3.0	cnv_partition	207386
19	50339605	50393269		AD2	1.0	cnv_partition	53664
19	1219342	1302888		Kolf2-c1	1.0	cnv_partition	83546
19	50299866	50375101		RD122 80:20_B4	1.0	cnv_partition	75235
19	38931470	39076588		RD122 80:20_B8	1.0	cnv_partition	145118
19	50296145	50394886		RD122 80:20_B8	1.0	cnv_partition	98741
19	50299866	50380858		RD122 80:20_C2	1.0	cnv_partition	80992
19	50299866	50375101		RD12280:20_C6	1.0	cnv_partition	75235
2	39216404	39602792		AD2	3.0	cnv_partition	386388
2	47635524	47710541		AD2	3.0	cnv_partition	75017
2	48030825	48300241		AD2	3.0	cnv_partition	269416
2	175572035	176929979		AD2	2.0	cnv_partition	1357944
2	47635539	47751215		AD3_AZ	3.0	cnv_partition	115676
2	48030825	48300241		AD3_AZ	3.0	cnv_partition	269416
2	47635542	47751215		AD3_P4	3.0	cnv_partition	115673
2	47635524	47751215		Kolf2-c1	3.0	cnv_partition	115691
2	183449725	184137284		Kolf2-c1	3.0	cnv_partition	687559
2	185389340	186880879		Kolf2-c1	2.0	cnv_partition	1491539
2	39224112	39602792		LN511-B5	3.0	cnv_partition	378680
2	47635524	47710084		LN511-B5	3.0	cnv_partition	74560
2	48030825	48230978		LN511-B5	3.0	cnv_partition	200153
2	187871643	189872861		LN511-B5	3.0	cnv_partition	2001218
2	185389340	186880879		LN511-B5	2.0	cnv_partition	1491539
2	39216404	39602792		LN511-C11	3.0	cnv_partition	386388
2	47635524	47751215		LN511-C11	3.0	cnv_partition	115691
2	48030825	48230978		LN511-C11	3.0	cnv_partition	200153
2	188033045	189873659		LN511-C11	3.0	cnv_partition	1840614
2	135281133	136830635		LN511-C11	2.0	cnv_partition	1549502
2	185389340	186880879		LN511-C11	2.0	cnv_partition	1491539
2	39216404	39331522		LN511-D4	3.0	cnv_partition	115118
2	47635524	47708589		LN511-D4	3.0	cnv_partition	73065
2	135281133	136830635		LN511-D4	2.0	cnv_partition	1549502
2	185389340	186880879		LN511-D4	2.0	cnv_partition	1491539
2	47635524	47709916		LN511-E5	3.0	cnv_partition	74392
2	135803425	136479698		LN511-E5	3.0	cnv_partition	676273
2	185389340	186880879		LN511-E5	2.0	cnv_partition	1491539
2	39224112	39331522		LN521-B2	3.0	cnv_partition	107410
2	47635542	47751215		LN521-B2	3.0	cnv_partition	115673
2	188131502	189872861		LN521-B2	3.0	cnv_partition	1741359
2	135281133	136830635		LN521-B2	2.0	cnv_partition	1549502
2	185389340	186880879		LN521-B2	2.0	cnv_partition	1491539
2	47635542	47698203		LN521-E2	3.0	cnv_partition	62661
2	48030825	48233949		LN521-E2	3.0	cnv_partition	203124
2	187871643	189872861		LN521-E2	3.0	cnv_partition	2001218
2	185389340	186880879		LN521-E2	2.0	cnv_partition	1491539
2	47635524	47693949		LN521-F11	3.0	cnv_partition	58425
2	188131502	189872861		LN521-F11	3.0	cnv_partition	1741359
2	185389340	186880879		LN521-F11	2.0	cnv_partition	1491539
2	47635524	47709913		LN521-G11	3.0	cnv_partition	74389
2	48030825	48230978		LN521-G11	3.0	cnv_partition	200153
2	166848897	168442147		LN521-G11	3.0	cnv_partition	1593250
2	188145507	189872861		LN521-G11	3.0	cnv_partition	1727354
2	135281133	136830635		LN521-G11	2.0	cnv_partition	1549502
2	185389340	186880879		LN521-G11	2.0	cnv_partition	1491539
2	39216404	39602792		MG-C11	3.0	cnv_partition	386388
2	47635524	47751215		MG-C11	3.0	cnv_partition	115691
2	166848897	168442147		MG-C11	3.0	cnv_partition	1593250
2	188131502	189873659		MG-C11	3.0	cnv_partition	1742157
2	135281133	136830635		MG-C11	2.0	cnv_partition	1549502
2	185389340	186880879		MG-C11	2.0	cnv_partition	1491539
2	47635542	47710084		MG-D7	3.0	cnv_partition	74542
2	135281133	136830635		MG-D7	2.0	cnv_partition	1549502
2	185389340	186880879		MG-D7	2.0	cnv_partition	1491539
2	39216404	39331522		MG-E3	3.0	cnv_partition	115118
2	47635524	47751215		MG-E3	3.0	cnv_partition	115691
2	135281133	136830635		MG-E3	2.0	cnv_partition	1549502
2	185389340	186880879		MG-E3	2.0	cnv_partition	1491539
2	47639598	47698203		MG-G5	3.0	cnv_partition	58605
2	48032047	48230978		MG-G5	3.0	cnv_partition	198931
2	185389340	186880879		MG-G5	2.0	cnv_partition	1491539
2	47635542	47703501		RD122 80:20_B1	3.0	cnv_partition	67959
2	77043860	77783184		RD122 80:20_B1	3.0	cnv_partition	739324
2	135988235	137902997		RD122 80:20_B1	2.0	cnv_partition	1914762
2	203602207	205062901		RD122 80:20_B1	2.0	cnv_partition	1460694
2	47635542	47702160		RD122 80:20_B4	3.0	cnv_partition	66618
2	135988235	137902997		RD122 80:20_B4	2.0	cnv_partition	1914762
2	203602207	205062901		RD122 80:20_B4	2.0	cnv_partition	1460694
2	47639598	47702411		RD122 80:20_B6	3.0	cnv_partition	62813
2	135988235	137902997		RD122 80:20_B6	2.0	cnv_partition	1914762
2	203602207	205062901		RD122 80:20_B6	2.0	cnv_partition	1460694
2	47635542	47703501		RD122 80:20_B7	3.0	cnv_partition	67959
2	76997763	78827915		RD122 80:20_B7	3.0	cnv_partition	1830152
2	135988235	137902997		RD122 80:20_B7	2.0	cnv_partition	1914762
2	203602207	205062901		RD122 80:20_B7	2.0	cnv_partition	1460694
2	47639598	47703501		RD122 80:20_B8	3.0	cnv_partition	63903
2	135988235	137902997		RD122 80:20_B8	2.0	cnv_partition	1914762
2	203602207	205062901		RD122 80:20_B8	2.0	cnv_partition	1460694
2	47635542	47702163		RD122 80:20_C2	3.0	cnv_partition	66621
2	189853017	191158930		RD122 80:20_C2	3.0	cnv_partition	1305913
2	135988235	137902997		RD122 80:20_C2	2.0	cnv_partition	1914762
2	203602207	205062901		RD122 80:20_C2	2.0	cnv_partition	1460694
2	47639598	47702160		RD122 80:20_C4	3.0	cnv_partition	62562
2	135988235	137902997		RD122 80:20_C4	2.0	cnv_partition	1914762
2	203602207	205062901		RD122 80:20_C4	2.0	cnv_partition	1460694
2	47639598	47710084		RD12280:20_C6	3.0	cnv_partition	70486
2	135988235	137902997		RD12280:20_C6	2.0	cnv_partition	1914762
2	203602207	205062901		RD12280:20_C6	2.0	cnv_partition	1460694
20	62084720	62139572		AD2	1.0	cnv_partition	54852
20	29811475	31885139		AD3_AZ	3.0	cnv_partition	2073664
20	29811475	31885139		AD3_P4	3.0	cnv_partition	2073664
20	29811475	30745269		RD122 80:20_B1	3.0	cnv_partition	933794
20	29811475	30745269		RD122 80:20_B4	3.0	cnv_partition	933794
20	29432371	30745269		RD122 80:20_B6	3.0	cnv_partition	1312898
20	29432371	30980453		RD122 80:20_B7	3.0	cnv_partition	1548082
20	29811475	30745269		RD122 80:20_B8	3.0	cnv_partition	933794
20	29811475	30745269		RD122 80:20_C2	3.0	cnv_partition	933794
20	29432371	30745269		RD122 80:20_C4	3.0	cnv_partition	1312898
20	29432371	31003212		RD12280:20_C6	3.0	cnv_partition	1570841
22	24300611	24377733		AD3_AZ	1.0	cnv_partition	77122
22	33945678	34298354		AD3_AZ	1.0	cnv_partition	352676
22	24300635	24379382		AD3_P4	1.0	cnv_partition	78747
22	33945678	34298354		AD3_P4	1.0	cnv_partition	352676
3	118745936	118818656		AD2	3.0	cnv_partition	72720
3	64729892	65150870		AD3_AZ	3.0	cnv_partition	420978
3	64734932	65150083		AD3_P4	3.0	cnv_partition	415151
3	61136894	61905527		Kolf2-c1	3.0	cnv_partition	768633
3	72289657	72404542		Kolf2-c1	1.0	cnv_partition	114885
3	132141174	132438660		Kolf2-c1	3.0	cnv_partition	297486
3	55808202	56865776		Kolf2-c1	2.0	cnv_partition	1057574
3	61047068	61897451		LN511-B5	3.0	cnv_partition	850383
3	72289657	72404542		LN511-B5	1.0	cnv_partition	114885
3	132158769	132491193		LN511-B5	3.0	cnv_partition	332424
3	55808202	56865776		LN511-B5	2.0	cnv_partition	1057574
3	61143949	61973292		LN511-C11	3.0	cnv_partition	829343
3	72289657	72404542		LN511-C11	1.0	cnv_partition	114885
3	55808202	56865776		LN511-C11	2.0	cnv_partition	1057574
3	61145609	61528270		LN511-D4	3.0	cnv_partition	382661
3	72306268	72424795		LN511-D4	1.0	cnv_partition	118527
3	55808202	56865776		LN511-D4	2.0	cnv_partition	1057574
3	61047068	61897451		LN511-E5	3.0	cnv_partition	850383
3	72289657	72404542		LN511-E5	1.0	cnv_partition	114885
3	123558668	123684339		LN511-E5	3.0	cnv_partition	125671
3	55808202	56865776		LN511-E5	2.0	cnv_partition	1057574
3	61143949	61528270		LN521-B2	3.0	cnv_partition	384321
3	72289657	72424795		LN521-B2	1.0	cnv_partition	135138
3	55808202	56865776		LN521-B2	2.0	cnv_partition	1057574
3	61143949	61897451		LN521-E2	3.0	cnv_partition	753502
3	72289657	72424795		LN521-E2	1.0	cnv_partition	135138
3	55808202	56865776		LN521-E2	2.0	cnv_partition	1057574
3	61143949	61528270		LN521-F11	3.0	cnv_partition	384321
3	72289657	72404542		LN521-F11	1.0	cnv_partition	114885
3	55808202	56865776		LN521-F11	2.0	cnv_partition	1057574
3	61143949	61973292		LN521-G11	3.0	cnv_partition	829343
3	72289657	72404542		LN521-G11	1.0	cnv_partition	114885
3	123558668	123684339		LN521-G11	3.0	cnv_partition	125671
3	132213034	132438660		LN521-G11	3.0	cnv_partition	225626
3	55808202	56865776		LN521-G11	2.0	cnv_partition	1057574
3	61136894	61973292		MG-C11	3.0	cnv_partition	836398
3	72289657	72424795		MG-C11	1.0	cnv_partition	135138
3	132157429	132438660		MG-C11	3.0	cnv_partition	281231
3	55808202	56865776		MG-C11	2.0	cnv_partition	1057574
3	61136894	61905527		MG-D7	3.0	cnv_partition	768633
3	72289657	72404542		MG-D7	1.0	cnv_partition	114885
3	55808202	56865776		MG-D7	2.0	cnv_partition	1057574
3	61047068	61973292		MG-E3	3.0	cnv_partition	926224
3	72289657	72404542		MG-E3	1.0	cnv_partition	114885
3	123558668	123684339		MG-E3	3.0	cnv_partition	125671
3	132158769	132438660		MG-E3	3.0	cnv_partition	279891
3	55808202	56865776		MG-E3	2.0	cnv_partition	1057574
3	61136894	61897451		MG-G5	3.0	cnv_partition	760557
3	72289657	72424795		MG-G5	1.0	cnv_partition	135138
3	55808202	56865776		MG-G5	2.0	cnv_partition	1057574
3	123558668	123684339		RD122 80:20_B1	3.0	cnv_partition	125671
3	43618202	44880294		RD122 80:20_B1	2.0	cnv_partition	1262092
3	43618202	44880294		RD122 80:20_B4	2.0	cnv_partition	1262092
3	43618202	44880294		RD122 80:20_B6	2.0	cnv_partition	1262092
3	43618202	44880294		RD122 80:20_B8	2.0	cnv_partition	1262092
3	43618202	44880294		RD122 80:20_C2	2.0	cnv_partition	1262092
3	43618202	44880294		RD122 80:20_C4	2.0	cnv_partition	1262092
3	43618202	44880294		RD12280:20_C6	2.0	cnv_partition	1262092
4	958274	1020882		AD2	0.0	cnv_partition	62608
4	1786702	1893167		AD2	1.0	cnv_partition	106465
4	69430742	69531327		Kolf2-c1	3.0	cnv_partition	100585
4	101194725	102227246		Kolf2-c1	2.0	cnv_partition	1032521
4	70289417	70672152		LN511-B5	3.0	cnv_partition	382735
4	101194725	102227246		LN511-B5	2.0	cnv_partition	1032521
4	70289417	70600199		LN511-C11	3.0	cnv_partition	310782
4	101194725	102227246		LN511-C11	2.0	cnv_partition	1032521
4	70289417	70723681		LN511-D4	3.0	cnv_partition	434264
4	101194725	102227246		LN511-D4	2.0	cnv_partition	1032521
4	69430742	69531327		LN511-E5	3.0	cnv_partition	100585
4	101194725	102227246		LN511-E5	2.0	cnv_partition	1032521
4	70354534	70600440		LN521-B2	3.0	cnv_partition	245906
4	101194725	102227246		LN521-B2	2.0	cnv_partition	1032521
4	69430742	69531327		LN521-E2	3.0	cnv_partition	100585
4	101194725	102227246		LN521-E2	2.0	cnv_partition	1032521
4	70348090	70600199		LN521-F11	3.0	cnv_partition	252109
4	101194725	102227246		LN521-F11	2.0	cnv_partition	1032521
4	69430742	69531327		LN521-G11	3.0	cnv_partition	100585
4	101194725	102227246		LN521-G11	2.0	cnv_partition	1032521
4	69430742	69531327		MG-C11	3.0	cnv_partition	100585
4	101194725	102227246		MG-C11	2.0	cnv_partition	1032521
4	69430742	69530098		MG-D7	3.0	cnv_partition	99356
4	101194725	102227246		MG-D7	2.0	cnv_partition	1032521
4	70289417	70723681		MG-E3	3.0	cnv_partition	434264
4	101194725	102227246		MG-E3	2.0	cnv_partition	1032521
4	101194725	102227246		MG-G5	2.0	cnv_partition	1032521
4	134157609	135806434		RD122 80:20_B1	2.0	cnv_partition	1648825
4	134157609	135806434		RD122 80:20_B4	2.0	cnv_partition	1648825
4	134157609	135806434		RD122 80:20_B6	2.0	cnv_partition	1648825
4	90958245	93553252		RD122 80:20_B7	3.0	cnv_partition	2595007
4	134157609	135806434		RD122 80:20_B7	2.0	cnv_partition	1648825
4	134157609	135806434		RD122 80:20_B8	2.0	cnv_partition	1648825
4	134157609	135806434		RD122 80:20_C2	2.0	cnv_partition	1648825
4	134157609	135806434		RD122 80:20_C4	2.0	cnv_partition	1648825
4	134157609	135806434		RD12280:20_C6	2.0	cnv_partition	1648825
5	36986184	37272728		AD2	3.0	cnv_partition	286544
5	112090601	112170636		AD2	3.0	cnv_partition	80035
5	112068338	112164670		AD3_AZ	3.0	cnv_partition	96332
5	112090601	112164558		AD3_P4	3.0	cnv_partition	73957
5	36805679	37272728		Kolf2-c1	3.0	cnv_partition	467049
5	112090601	112170636		Kolf2-c1	3.0	cnv_partition	80035
5	36764235	37751724		LN511-B5	3.0	cnv_partition	987489
5	112086874	112164558		LN511-B5	3.0	cnv_partition	77684
5	133026901	133233507		LN511-B5	3.0	cnv_partition	206606
5	36764235	37272728		LN511-C11	3.0	cnv_partition	508493
5	112111439	112170636		LN511-C11	3.0	cnv_partition	59197
5	36986184	37272728		LN511-D4	3.0	cnv_partition	286544
5	36986184	37418713		LN511-E5	3.0	cnv_partition	432529
5	112090601	112164558		LN511-E5	3.0	cnv_partition	73957
5	36911625	37568411		LN521-B2	3.0	cnv_partition	656786
5	112086874	112170636		LN521-B2	3.0	cnv_partition	83762
5	36986184	37272728		LN521-E2	3.0	cnv_partition	286544
5	112090601	112170636		LN521-E2	3.0	cnv_partition	80035
5	36764235	37272728		LN521-F11	3.0	cnv_partition	508493
5	112090601	112170636		LN521-F11	3.0	cnv_partition	80035
5	36986184	37418713		LN521-G11	3.0	cnv_partition	432529
5	112090601	112170682		LN521-G11	3.0	cnv_partition	80081
5	36986184	37418713		MG-C11	3.0	cnv_partition	432529
5	112111439	112170636		MG-C11	3.0	cnv_partition	59197
5	36986184	37751724		MG-D7	3.0	cnv_partition	765540
5	112090601	112170636		MG-D7	3.0	cnv_partition	80035
5	36898424	37294473		MG-E3	3.0	cnv_partition	396049
5	112111439	112170636		MG-E3	3.0	cnv_partition	59197
5	131915005	131977907		MG-E3	3.0	cnv_partition	62902
5	36986184	37272728		MG-G5	3.0	cnv_partition	286544
5	112090601	112170636		MG-G5	3.0	cnv_partition	80035
5	36759602	37418713		RD122 80:20_B1	3.0	cnv_partition	659111
5	112090601	112164557		RD122 80:20_B1	3.0	cnv_partition	73956
5	36764235	37568411		RD122 80:20_B4	3.0	cnv_partition	804176
5	112090601	112163704		RD122 80:20_B4	3.0	cnv_partition	73103
5	36986184	37418713		RD122 80:20_B6	3.0	cnv_partition	432529
5	112090601	112164557		RD122 80:20_B6	3.0	cnv_partition	73956
5	36986184	37294473		RD122 80:20_B7	3.0	cnv_partition	308289
5	131840396	131977907		RD122 80:20_B7	3.0	cnv_partition	137511
5	36764235	37304547		RD122 80:20_B8	3.0	cnv_partition	540312
5	112086874	112164557		RD122 80:20_B8	3.0	cnv_partition	77683
5	36764235	37418713		RD122 80:20_C2	3.0	cnv_partition	654478
5	45906203	46313227		RD122 80:20_C2	3.0	cnv_partition	407024
5	131902931	131977907		RD122 80:20_C2	3.0	cnv_partition	74976
5	36764235	37568411		RD122 80:20_C4	3.0	cnv_partition	804176
5	112090601	112164557		RD122 80:20_C4	3.0	cnv_partition	73956
5	36764235	37568411		RD12280:20_C6	3.0	cnv_partition	804176
5	112086874	112164557		RD12280:20_C6	3.0	cnv_partition	77683
6	15487649	15722102		Kolf2-c1	1.0	cnv_partition	234453
6	42672100	43685195		Kolf2-c1	2.0	cnv_partition	1013095
6	15487649	15739843		LN511-B5	1.0	cnv_partition	252194
6	42672100	43685195		LN511-B5	2.0	cnv_partition	1013095
6	15487649	15722102		LN511-C11	1.0	cnv_partition	234453
6	48899040	49425764		LN511-C11	3.0	cnv_partition	526724
6	42672100	43685195		LN511-C11	2.0	cnv_partition	1013095
6	15487649	15739843		LN511-D4	1.0	cnv_partition	252194
6	42672100	43685195		LN511-D4	2.0	cnv_partition	1013095
6	15487649	15722102		LN511-E5	1.0	cnv_partition	234453
6	42672100	43685195		LN511-E5	2.0	cnv_partition	1013095
6	15487649	15722102		LN521-B2	1.0	cnv_partition	234453
6	42672100	43685195		LN521-B2	2.0	cnv_partition	1013095
6	15487649	15722102		LN521-E2	1.0	cnv_partition	234453
6	18129722	18190435		LN521-E2	3.0	cnv_partition	60713
6	42672100	43685195		LN521-E2	2.0	cnv_partition	1013095
6	15487649	15722102		LN521-F11	1.0	cnv_partition	234453
6	42672100	43685195		LN521-F11	2.0	cnv_partition	1013095
6	15487649	15734884		LN521-G11	1.0	cnv_partition	247235
6	18129722	18190435		LN521-G11	3.0	cnv_partition	60713
6	42672100	43685195		LN521-G11	2.0	cnv_partition	1013095
6	15487649	15722102		MG-C11	1.0	cnv_partition	234453
6	49046961	49425764		MG-C11	3.0	cnv_partition	378803
6	42672100	43685195		MG-C11	2.0	cnv_partition	1013095
6	15487649	15722102		MG-D7	1.0	cnv_partition	234453
6	42672100	43685195		MG-D7	2.0	cnv_partition	1013095
6	15487649	15739843		MG-E3	1.0	cnv_partition	252194
6	42672100	43685195		MG-E3	2.0	cnv_partition	1013095
6	15487649	15722102		MG-G5	1.0	cnv_partition	234453
6	42672100	43685195		MG-G5	2.0	cnv_partition	1013095
6	5571672	5632371		RD122 80:20_B6	1.0	cnv_partition	60699
6	5571672	5632371		RD122 80:20_B8	1.0	cnv_partition	60699
7	117130915	117305620		AD2	3.0	cnv_partition	174705
7	9066820	9127173		AD3_AZ	1.0	cnv_partition	60353
7	20731918	20823569		Kolf2-c1	3.0	cnv_partition	91651
7	117227785	117292959		Kolf2-c1	3.0	cnv_partition	65174
7	140417863	140517444		Kolf2-c1	3.0	cnv_partition	99581
7	91565644	92326346		LN511-B5	3.0	cnv_partition	760702
7	117227785	117292959		LN511-B5	3.0	cnv_partition	65174
7	140394547	140569676		LN511-B5	3.0	cnv_partition	175129
7	117130915	117292957		LN511-C11	3.0	cnv_partition	162042
7	140439727	140569676		LN511-C11	3.0	cnv_partition	129949
7	117142898	117292959		LN511-D4	3.0	cnv_partition	150061
7	140417863	140569676		LN511-D4	3.0	cnv_partition	151813
7	117142898	117305619		LN511-E5	3.0	cnv_partition	162721
7	117142898	117305620		LN521-B2	3.0	cnv_partition	162722
7	117171169	117305620		LN521-E2	3.0	cnv_partition	134451
7	20732726	20815352		LN521-F11	3.0	cnv_partition	82626
7	117142898	117292957		LN521-F11	3.0	cnv_partition	150059
7	140394547	140517444		LN521-F11	3.0	cnv_partition	122897
7	117175417	117292959		LN521-G11	3.0	cnv_partition	117542
7	140453192	140569676		LN521-G11	3.0	cnv_partition	116484
7	117142898	117292959		MG-C11	3.0	cnv_partition	150061
7	140417863	140544969		MG-C11	3.0	cnv_partition	127106
7	20732726	20819770		MG-D7	3.0	cnv_partition	87044
7	117130915	117292959		MG-D7	3.0	cnv_partition	162044
7	140454006	140517444		MG-D7	3.0	cnv_partition	63438
7	117142898	117290010		MG-E3	3.0	cnv_partition	147112
7	140417863	140569676		MG-E3	3.0	cnv_partition	151813
7	117144332	117305620		MG-G5	3.0	cnv_partition	161288
7	65436108	65579838		RD122 80:20_B1	1.0	cnv_partition	143730
7	65436108	65557801		RD122 80:20_B7	1.0	cnv_partition	121693
7	65436108	65557801		RD122 80:20_B8	1.0	cnv_partition	121693
7	117227785	117291132		RD122 80:20_B8	3.0	cnv_partition	63347
7	65436108	65579838		RD122 80:20_C2	1.0	cnv_partition	143730
7	117143602	117232518		RD122 80:20_C2	3.0	cnv_partition	88916
7	128475604	128562578		RD122 80:20_C2	1.0	cnv_partition	86974
7	65436108	65557801		RD12280:20_C6	1.0	cnv_partition	121693
7	128415195	128562578		RD12280:20_C6	1.0	cnv_partition	147383
8	145541626	145750506		AD2	1.0	cnv_partition	208880
8	66156258	67188281		AD2	2.0	cnv_partition	1032023
8	83722343	84736331		AD3_AZ	2.0	cnv_partition	1013988
8	83722343	84736331		AD3_P4	2.0	cnv_partition	1013988
8	94768027	94821362		LN511-D4	3.0	cnv_partition	53335
8	137727375	137855721		RD122 80:20_B1	1.0	cnv_partition	128346
8	137770311	137855721		RD122 80:20_B4	1.0	cnv_partition	85410
8	137734805	137855721		RD122 80:20_B6	1.0	cnv_partition	120916
8	50755689	51558988		RD122 80:20_B7	3.0	cnv_partition	803299
8	137770311	137855721		RD122 80:20_B8	1.0	cnv_partition	85410
8	137727375	137855721		RD122 80:20_C4	1.0	cnv_partition	128346
9	106483432	106725673		AD2	1.0	cnv_partition	242241
9	139904658	140188578		AD2	1.0	cnv_partition	283920
9	113639333	114831484		AD3_AZ	2.0	cnv_partition	1192151
9	113639333	114831484		AD3_P4	2.0	cnv_partition	1192151
9	119244942	119355584		Kolf2-c1	1.0	cnv_partition	110642
9	119244942	119355584		LN521-E2	1.0	cnv_partition	110642
9	119244942	119345414		MG-C11	1.0	cnv_partition	100472
9	119244942	119355584		MG-D7	1.0	cnv_partition	110642
9	119244942	119355584		MG-E3	1.0	cnv_partition	110642
9	119244942	119355584		MG-G5	1.0	cnv_partition	110642
